1111111111
1000000001
1111100001
1000000001
1010111111
1010100001
1010100001
1011100001
1000000001
1000000001
1001111001
1001$01001
1001001001
10010000U1
1111111111