1111111111
1000000001
1000000001
1000000001
10000000U1
1000000001
1000000001
1000000001
1000000001
1000100001
1000100001
1000100001
1000111111
10000000D1
1111111111